# BẢNG MÃ ĐỊA HÌNH:
# 0: DEEP_WATER (Sông, Biển, Hồ)
# 1: GRASSLAND  (Đồng cỏ)
# 2: FOREST     (Rừng rậm)
# 3: MOUNTAIN   (Vách núi)
# 4: MUD        (Bùn lầy)

0 0 0 1 2 2 2 2 2 1 1 1 1 1 1 3 3 3 3 3
0 0 1 2 2 2 2 2 1 1 0 1 1 1 1 3 3 3 3 3
0 1 1 2 2 2 2 2 1 1 0 0 1 1 1 3 3 3 3 3
0 1 1 1 2 2 2 1 1 1 1 0 1 1 1 1 3 3 3 3
0 1 1 1 1 1 1 1 1 1 0 0 1 1 1 1 3 3 3 3
0 0 1 1 1 1 1 1 1 1 0 1 1 1 1 1 1 3 3 3
0 0 0 1 0 0 0 0 1 1 0 4 4 1 1 1 1 3 3 3
0 0 1 0 0 0 0 0 1 1 0 0 0 0 1 1 1 1 3 3
0 1 1 0 0 0 0 0 1 1 1 1 1 0 1 1 1 1 3 3
0 1 1 1 0 0 0 0 1 1 1 1 1 0 1 1 1 1 3 3
0 1 1 1 1 0 1 1 1 1 1 2 2 2 2 2 2 1 3 3
0 1 1 1 1 0 0 1 1 1 1 2 2 2 2 2 2 1 3 3
0 0 1 1 4 4 0 1 1 1 1 2 2 2 2 2 2 1 3 3
0 0 1 1 1 1 0 0 1 1 1 2 2 2 2 2 2 1 3 3
0 1 1 1 1 1 1 0 1 1 1 2 2 2 2 2 2 1 3 3
0 1 1 1 1 1 1 0 1 1 1 1 2 2 2 2 1 1 3 3
0 0 1 1 1 1 1 0 1 1 1 1 1 1 1 1 1 1 3 3
0 0 1 4 4 1 1 0 1 1 1 1 1 1 1 1 1 1 3 3
0 0 1 1 1 1 0 0 1 1 1 1 1 1 1 1 1 1 3 3
0 0 1 1 1 1 0 0 1 1 1 1 1 1 1 1 1 1 3 3